1111111111111111111111111111111111111111
1P001C000000100C00000C0000000001000C1E01
10101101101010111011110101CC0101000C1101
10101101101C10100C11110101110101010C1001
10C010011000C0100010000100000001C10C1011
10001CX11000101C00100C0100000101010C1001
10101101C01010101010010111110100010C1101
1010111110101010001C010000010101110C1001
100000B10C00C0000011111100000000C10C1001
110011010000111100000C000CCC0001000C1001
11001101111111110000CC00C000C001000C1101
1100113000001111000C0C000000C001000C1001
110011111110111100C00C000000C001000C1011
11001100000010000CCCCC000000C001000C1001
110011011111111000000C00000C0001000C1101
110011000000111100000C0000C00001000C1001
110011111110111100000C000C000001000C1011
11CC11C00000000000000C00C0000001000C1001
11CC11111111111100000C00CCCCC001000C0001
1111111111111111111111111111111111111111
