11111111111111111
11000000001000001
1C000000001000001
10000001000000111
10000100000000111
10010000000000111
10001000000000111
10000100000000111
10000010000000111
10000000000000111
10000001000000111
10000010000000111
10100001000000111
11000000001000111
1C000000001000111
10000001000000111
10000100000000111
10010000000000111
10001000000000111
10000100000000111
10000010000000111
10000000000000111
10000001000000111
10000010000000111
11000001000000111
1P000000000000111
1C000000001000111
10000001000000111
10000100000000111
10010000000000111
10001000000000111
10000100000000111
10000010000000111
10000000000000111
10000001000000111
10000010000000111
1E000001000000111
11111111111111111
