11111111111111111111111111111111
1P0000B0000B0000B00000B000000001
10101010101010101010101010101001
10000B00000B00000B00000B00000001
10101010101010101010101010101001
10000B00000B00003B00000B00000011
10101010101010101010101010101001
100000000000000C0000000000000001
10101010101010101010101010101001
10000B00000B00C03B00000B00000001
10101010101010101010101010101001
10000B00000B00C00B00003B00000001
10101010101010101010101010101001
100000B0000C0000B000000000000011
101010101000100010000000000E0001
11111111111111111111111111111111
