1111111111111111111111111111111111111111111111111
1P001C000000100C00000C0000000001E10000C0000000001
10101101101010111011110101CC0101010000C0000000001
10101101101C10100C111101011101010101C000000100C01
10C01C011000C0100010000100000001C10000C0000000001
10C01C011000C010000100C000000100C00000C0000000001
10C01C011000C0130010000100000001C00000C0000000001
10C01C011000C0100010000100000001C10100C0000000001
10001C01100X101C000101C000000100C00000C0000000001
101010B101111101000101C000000100C00000C0000000001
1010110110101010B01C01000001010111000000000000001
100000030C10C0000011111100000100C00000C0000000001
1111111111111111111111111111111111111111111111111
