1111111111111
1P01000000001
1001011111001
10X0000000001
1030000000001
10B00000CEC01
1111111111111
